REM **** LEVEL 1 (0-200) - The beginning
 0,0,0,0,0,0,0,0,0,0,0,0,0,0,0,0,0,0,0,0
 2,4,6,8,6,4,4,4,4,4,4,4,4,4,4,4,5,2,2,0
 0,0,0,0,0,0,2,1,1,1,1,1,1,1,1,3,0,0,0,0
 
 0,0,0,0,0,0,0,0,0,0,0,0,0,0,0,0,0,0,0,0
 0,3,3,3,3,3,3,5,5,5,5,5,7,7,7,7,7,9,9,9
 0,0,1,0,1,0,3,0,1,0,3,0,0,1,0,3,0,0,1,0
 
 0,0,0,0,0,0,0,0,0,0,0,0,0,0,0,0,0,0,0,0
 6,3,1,1,1,2,2,3,3,4,4,5,5,6,6,7,7,8,8,9
 0,0,0,0,1,0,1,0,1,0,1,0,1,0,1,0,1,0,2,0
 
 0,0,0,0,0,0,0,0,0,0,0,0,0,0,0,0,0,0,0,0
 6,3,0,0,0,0,0,0,0,0,0,0,0,5,3,3,5,3,3,5
 0,0,0,1,1,1,1,1,1,1,1,1,0,0,0,2,0,0,2,0
 
 0,0,0,0,0,0,0,0,0,0,0,0,0,0,0,0,0,0,0,0
 3,3,3,3,5,4,4,4,4,4,6,8,7,6,6,6,6,6,6,6
 0,1,1,3,0,0,2,1,3,1,0,0,0,0,2,1,3,1,2,1
 
 0,0,0,0,0,0,0,0,0,0,0,0,0,0,0,0,0,0,0,0
 4,0,0,4,0,0,4,1,1,4,0,0,5,9,6,6,3,3,3,3
 0,0,1,0,0,2,0,0,3,0,0,1,0,0,0,2,0,1,1,1
 
 0,0,0,0,0,0,0,0,0,0,0,0,0,0,0,0,0,0,0,0
 4,4,4,4,5,5,5,6,6,7,6,6,5,5,5,4,4,4,4,3
 0,1,1,2,0,1,3,0,1,0,0,1,0,1,3,0,1,1,3,0
 
 0,0,0,0,0,0,0,0,0,0,0,0,0,0,0,0,0,0,0,0
 7,6,2,2,6,7,6,2,2,6,8,6,2,2,7,9,7,2,2,3
 0,0,0,1,0,0,0,0,1,0,0,0,0,1,0,0,0,0,1,0
 
 0,0,0,0,0,0,0,0,0,0,0,0,0,0,0,0,0,0,0,0
 5,9,0,0,0,0,0,0,0,0,0,0,0,0,9,5,3,2,2,1
 0,0,0,1,1,1,1,3,1,3,1,1,1,1,0,0,0,0,3,0
 
 0,0,0,0,0,0,0,0,0,0,0,0,0,0,0,0,0,0,0,0
 1,4,7,9,9,9,9,9,7,3,4,5,5,5,4,2,2,3,2,1
 0,0,0,0,1,1,1,1,0,0,0,0,3,2,0,0,1,0,0,0
REM **** LEVEL 2 (201-400) - the caves
 1,1,1,1,2,2,2,2,3,3,3,3,4,4,4,4,5,5,5,5
 1,1,1,1,2,2,2,2,3,3,3,3,4,4,4,4,5,5,5,5
 0,1,0,3,0,1,0,3,0,1,0,3,0,1,0,3,0,1,1,1
 
 6,6,6,6,7,7,7,7,8,8,8,8,9,9,9,9,7,5,3,1
 4,4,4,4,3,3,3,3,2,2,2,2,1,1,1,1,1,3,5,7
 0,2,0,3,0,1,1,1,0,1,1,1,0,1,1,1,0,0,0,0
 
 2,1,1,3,4,2,1,7,2,1,2,1,3,1,3,5,7,3,2,1
 5,3,4,4,3,3,3,3,2,2,2,2,1,1,1,1,1,3,5,3
 0,0,0,3,0,1,1,1,0,1,1,1,0,1,1,1,0,0,0,0
 
 1,1,1,1,2,2,2,2,1,1,1,1,4,4,4,4,2,2,1,1
 4,1,1,1,2,2,2,2,3,3,3,3,4,4,4,4,5,5,5,5
 0,0,0,3,0,1,1,1,0,1,1,3,0,1,1,2,0,1,1,1
 
 1,1,1,1,2,2,3,3,4,4,5,5,6,6,7,7,8,8,9,9
 4,6,8,8,8,7,7,6,6,5,5,4,4,3,3,2,2,1,1,0
 0,0,0,3,1,0,1,0,2,0,2,0,2,0,2,0,2,0,3,0
 
 6,6,6,6,5,5,5,5,4,4,4,4,3,3,3,3,2,2,2,2
 1,2,3,4,5,5,5,5,6,6,6,6,7,7,7,7,8,8,8,8
 0,0,0,0,0,1,3,1,0,1,1,1,0,1,1,1,0,1,2,3
 
 1,1,1,1,2,2,2,2,3,3,3,3,4,4,4,4,5,5,5,5
 7,7,6,6,5,5,4,4,3,3,3,3,4,4,4,4,5,5,5,5
 0,1,0,3,0,1,0,3,0,1,0,3,0,1,0,3,0,1,1,1
 
 6,6,6,6,7,7,7,7,8,8,8,8,9,9,9,7,5,3,1,1
 4,4,4,4,3,3,3,3,2,2,2,2,1,1,1,1,1,3,5,7
 0,2,0,3,0,1,1,1,0,1,1,1,0,1,1,1,0,0,0,0
 
 2,1,1,3,4,2,1,7,2,1,2,1,3,1,3,5,7,3,0,1
 5,3,4,4,3,3,3,3,2,2,2,2,1,1,1,1,1,3,5,7
 0,0,0,3,0,1,1,1,0,1,1,1,0,1,1,1,0,0,0,0
 
 2,1,1,3,4,2,1,7,2,1,2,1,3,1,3,5,7,3,1,1
 5,3,4,4,3,3,3,3,2,2,2,2,1,1,1,1,1,3,5,7
 0,0,0,3,0,1,1,1,0,1,1,1,0,1,1,1,0,0,0,0
REM **** LEVEL 3 (401-600) - The bouncers
 0,0,0,0,0,0,0,0,0,0,0,0,0,0,0,0,0,0,0,0
 3,3,3,3,4,4,4,4,5,5,5,6,6,6,6,6,6,6,6,6
 0,2,3,0,0,1,5,1,0,5,1,0,5,1,1,5,2,0,5,1
 
 0,0,0,0,0,0,0,0,0,0,0,0,0,0,0,0,0,0,0,0
 3,3,3,3,5,4,4,4,4,4,6,8,7,6,6,6,6,6,6,6
 0,0,5,0,0,5,1,1,5,3,0,5,0,0,5,1,3,5,3,1
 
 0,0,0,1,1,1,1,2,2,2,3,3,2,2,2,2,2,3,3,3
 3,3,3,3,5,4,4,3,3,2,2,2,2,3,3,2,2,2,2,2
 5,0,1,5,0,0,5,0,3,5,1,2,5,0,1,5,0,3,5,3
 
 4,4,5,5,5,4,4,4,3,3,3,2,1,1,3,5,5,2,2,2
 3,3,3,3,2,2,2,3,3,4,4,4,5,5,3,1,1,4,4,4
 5,1,5,1,5,1,5,0,5,0,5,3,5,0,5,0,5,0,5,3
 
 2,2,1,1,4,4,4,4,5,5,4,4,4,4,2,2,3,3,1,1
 3,3,3,3,2,2,1,1,1,2,2,2,4,4,1,1,1,4,4,4
 5,1,5,3,5,1,5,1,5,0,5,2,5,1,5,1,5,0,5,3
 
 0,0,0,0,0,0,0,0,0,0,0,0,0,0,0,0,0,0,0,0
 5,5,5,7,7,7,7,8,8,8,9,9,6,9,9,6,9,9,6,9
 5,1,5,0,5,1,5,0,5,3,5,2,6,0,1,5,0,1,5,0
 
 0,0,0,0,0,0,0,0,0,0,0,0,0,0,0,0,0,0,0,0
 9,6,9,9,6,9,9,6,9,7,5,3,1,0,4,1,6,2,7,3
 1,5,0,1,5,0,3,5,0,5,5,5,5,5,5,5,5,5,5,5
 
 0,0,0,0,0,0,0,0,0,0,0,0,0,0,0,0,0,0,0,0
 3,6,9,6,3,3,9,5,3,5,4,4,1,2,6,3,3,1,3,1
 5,5,5,5,5,3,5,5,5,5,5,3,5,5,5,5,3,5,5,5
 
 0,0,0,0,0,0,0,0,0,0,0,0,0,0,0,0,0,0,0,0
 4,5,5,3,1,5,4,6,6,2,3,7,8,5,4,1,3,3,4,5
 5,5,3,5,5,5,5,5,3,5,5,5,5,5,5,5,5,3,5,5
 
 0,0,0,0,0,0,0,0,0,0,0,0,0,0,0,0,0,0,0,0
 7,4,2,4,5,5,2,3,5,5,6,2,1,2,2,4,3,2,1,0
 5,5,5,5,5,3,5,5,5,3,5,5,0,5,3,5,0,5,0,0
REM **** LEVEL 4 (601-800) - The asteroids (ok, so there rockets !)
 0,0,0,0,0,0,0,0,0,0,0,0,0,0,0,0,0,0,0,0
 1,1,1,1,1,1,5,1,1,0,0,1,1,0,0,1,1,4,1,1
 0,1,0,2,0,1,0,0,0,0,1,4,1,4,3,4,4,4,4,4
 
 0,0,0,0,0,0,0,0,0,0,0,0,0,0,0,0,0,0,0,0
 1,1,0,0,0,4,0,0,0,1,1,1,0,0,0,4,1,1,1,1
 4,4,4,2,4,4,4,4,3,4,1,4,4,1,4,4,4,1,4,3
 
 0,0,0,0,0,0,0,0,0,0,0,0,0,0,0,0,0,0,0,0
 1,1,1,1,5,0,1,0,0,1,0,5,0,1,1,1,1,1,1,1
 4,4,1,4,4,4,4,4,3,4,4,4,4,4,1,3,4,1,3,4
 
 0,0,0,0,0,0,0,0,0,0,0,0,0,0,0,0,0,0,0,0
 1,1,0,0,4,0,0,0,0,0,0,3,0,0,0,0,0,0,0,0
 4,3,4,4,4,4,4,4,4,3,4,4,4,1,4,3,4,1,4,4
 
 0,0,0,0,0,0,0,0,0,0,0,0,0,0,0,0,0,0,0,0
 1,1,1,3,1,1,2,2,1,1,4,1,1,2,2,3,3,4,4,4
 4,4,1,4,4,1,4,3,4,4,4,4,4,4,4,4,4,4,4,4
 
 0,0,0,0,0,0,0,0,0,0,0,0,0,0,0,0,0,0,0,0
 5,5,4,4,2,2,0,0,0,3,0,0,1,1,0,0,0,4,0,0
 0,1,0,1,0,1,0,0,3,0,0,1,4,1,4,1,4,4,4,4
 
 0,0,1,2,3,2,1,0,0,0,0,0,0,0,0,1,2,3,2,1
 0,0,0,0,4,0,0,0,0,0,0,0,0,0,0,0,4,0,0,0
 4,4,4,3,4,4,4,3,4,4,1,4,4,3,4,4,4,4,4,3
 
 0,0,1,2,3,3,2,1,0,0,2,2,3,3,2,2,0,0,0,0
 0,0,0,0,0,0,0,0,0,4,0,0,0,0,0,0,0,0,0,3
 4,4,4,3,4,4,4,3,4,4,1,4,4,1,4,4,4,4,4,4
 
 0,2,4,2,0,2,4,2,0,2,4,2,0,2,4,2,0,2,4,2
 0,0,3,0,0,0,4,0,0,0,3,0,0,0,4,0,0,0,4,0
 4,4,4,4,4,3,4,4,1,4,4,4,4,3,4,4,1,4,4,4
 
 0,0,1,2,3,3,2,1,0,0,2,2,3,3,2,2,0,0,0,0
 0,0,0,0,0,0,0,0,0,4,0,0,0,0,0,0,0,0,0,0
 4,4,4,3,4,4,4,3,4,0,4,2,4,1,4,3,4,0,0,0
REM **** LEVEL 5 (801-1000) - The structure !
 0,0,0,0,0,0,0,0,0,0,0,0,0,0,0,0,0,0,0,0
 0,0,9,9,9,9,4,4,4,4,0,0,0,0,5,5,5,5,5,5
 0,0,0,1,2,3,0,1,1,1,0,1,1,1,0,1,1,1,3,0
 
 0,0,0,0,0,0,0,0,0,0,0,0,0,0,0,0,0,0,0,0
 7,7,7,7,7,2,2,2,2,0,0,0,0,0,4,4,4,4,4,4
 0,1,2,3,1,0,1,1,1,0,1,1,1,3,0,1,1,1,2,3
 
 0,0,5,5,5,5,5,5,1,1,1,1,1,1,1,1,1,6,6,6
 0,0,2,2,2,2,2,2,2,2,2,7,7,7,7,0,0,0,0,0
 0,0,0,1,1,1,0,3,0,1,0,0,1,0,1,0,1,1,1,0
 
 9,9,9,9,1,1,1,1,1,1,1,1,1,1,1,9,9,9,9,9
 0,0,0,0,0,0,8,8,8,8,8,4,4,4,0,0,0,0,0,0
 0,1,0,1,0,1,0,1,1,1,1,0,0,3,0,1,1,1,1,0
 
 1,1,1,1,1,1,1,1,4,4,4,4,4,4,4,8,8,8,8,8
 0,0,8,8,8,3,3,3,3,3,3,3,1,1,1,1,1,1,1,1
 0,0,0,1,3,0,1,1,1,1,1,0,0,1,1,1,0,0,1,1
 
 9,9,1,1,1,1,1,1,1,5,5,5,9,9,9,9,9,5,5,5
 1,1,1,1,6,6,6,1,1,1,1,1,0,0,0,0,0,0,0,0
 0,0,1,1,0,1,1,3,1,1,3,1,0,1,1,3,1,3,3,0
 
 1,1,1,1,1,1,7,7,7,7,7,7,7,4,4,4,4,4,4,4
 0,0,5,5,5,3,3,3,3,3,3,3,3,3,3,7,7,7,7,7
 0,1,0,1,1,0,1,1,1,3,1,1,1,3,0,0,1,3,0,1
 
 1,1,1,9,9,9,9,9,9,1,1,1,1,1,1,1,1,1,1,1
 7,2,2,2,2,2,1,1,1,1,1,6,6,6,6,6,6,6,0,0
 0,0,1,1,0,3,0,1,1,1,3,0,1,1,1,0,0,3,0,0
 
 5,5,5,5,5,2,2,2,2,2,2,2,2,2,2,6,6,6,6,6
 0,0,4,4,4,4,4,6,6,6,6,6,6,6,4,4,4,4,1,1
 1,1,0,1,1,1,1,0,1,1,1,1,0,0,0,1,1,1,0,1
 
 9,9,9,9,1,1,1,1,1,1,1,9,9,9,1,1,1,1,1,1
 1,1,1,1,1,1,9,9,9,1,1,1,1,1,1,1,9,9,9,1
 0,0,0,0,0,0,0,0,0,0,0,0,0,0,0,0,0,0,0,0
REM **** LEVEL 6 (1001-1200) - The BOSS !
 1,1,1,1,1,1,1,1,1,1,1,1,1,1,1,1,1,1,1,1
 1,1,1,1,1,1,1,1,1,1,1,1,1,1,1,1,1,1,1,1
 0,2,3,2,3,2,1,1,1,1,2,1,1,3,1,1,1,1,1,1
 
 2,2,2,2,2,2,2,2,2,2,2,2,2,2,2,2,2,2,2,2
 2,2,2,2,2,2,2,2,2,2,2,2,2,2,2,2,2,2,2,2
 0,1,2,1,1,3,1,1,3,2,3,3,1,1,1,2,3,2,1,2
 
 3,3,3,3,3,3,3,3,3,3,3,3,3,3,3,3,3,3,3,3
 3,3,3,3,3,3,3,3,3,3,3,3,3,3,3,3,3,3,3,3
 4,1,4,1,4,3,4,1,4,1,4,1,4,3,4,1,4,1,4,1
 
 4,4,4,4,4,4,4,4,4,4,4,4,4,4,4,4,4,4,4,4
 4,4,4,4,4,4,4,4,4,4,4,4,4,4,4,4,4,4,4,4
 5,1,5,1,5,3,5,1,5,1,5,3,5,1,5,1,5,1,5,1
 
 5,5,5,5,5,5,5,5,5,5,5,5,5,5,5,5,5,5,5,5
 5,5,5,5,5,5,5,5,5,5,5,5,5,5,5,5,5,5,5,5
 0,1,2,3,1,2,3,1,2,3,1,2,3,1,2,3,1,2,3,1
 
 5,5,5,5,4,4,4,4,3,3,3,3,2,2,2,2,1,1,1,1
 5,5,5,5,5,6,6,6,6,7,7,7,7,8,8,8,8,9,9,9
 1,2,3,2,3,0,1,1,1,0,1,1,1,0,1,1,1,0,1,1
 
 2,2,2,3,3,3,4,4,4,5,5,5,6,6,6,7,7,7,8,8
 8,8,8,7,7,7,6,6,6,5,5,5,4,4,4,3,3,3,2,2
 0,1,0,0,1,0,0,3,0,0,3,0,0,3,0,0,3,0,0,3
 
 1,2,3,4,5,6,7,8,9,9,9,8,7,6,5,4,3,2,2,1
 3,4,7,6,5,4,3,2,1,1,1,2,3,4,5,6,7,8,9,9
 0,0,0,0,0,0,0,0,0,3,0,0,0,0,0,0,0,0,0,3
 
 1,2,3,4,5,6,7,8,9,9,9,8,7,6,5,4,3,2,2,1
 9,8,7,6,5,4,3,2,1,1,1,2,3,4,5,6,7,8,9,9
 0,0,0,0,0,0,0,0,0,0,0,0,0,0,0,0,0,0,0,0
 
 1,1,1,1,1,1,1,1,1,1,1,1,2,3,4,5,6,7,8,9
 1,1,1,1,1,1,1,1,1,1,1,1,2,3,4,5,6,7,8,9
 0,0,0,0,0,0,0,0,0,0,9,0,0,0,0,0,0,0,0,0
