20
20
tileset1.png
map3.map
0,0,0,0,0,0,0,0,0,0,0,0,0,0,0,0,0,0,0,0
0,4,0,0,0,0,0,0,0,0,0,0,0,0,0,0,0,10,2,0
1,1,1,1,1,1,1,0,0,0,0,0,0,0,0,1,1,1,2,1
1,1,1,1,1,1,1,0,0,0,0,0,0,0,0,1,1,1,2,1
1,1,1,1,1,1,1,0,0,0,0,0,0,0,0,1,1,1,2,1
1,1,1,1,1,1,1,0,0,0,0,0,0,0,0,1,1,1,2,1
1,1,1,1,1,1,1,0,0,0,0,0,0,0,0,1,1,1,2,1
1,1,1,1,1,1,1,0,0,0,0,0,0,0,0,1,1,1,2,1
1,1,1,1,1,1,1,0,0,0,0,0,0,0,0,1,1,1,2,1
1,1,1,1,1,1,1,0,0,0,0,0,0,0,0,1,1,1,2,1
1,1,1,1,1,1,1,0,0,0,0,0,0,0,0,1,1,1,2,1
1,1,1,1,1,1,1,0,0,0,0,0,0,0,0,1,1,1,2,1
1,1,1,1,1,1,1,0,0,0,0,0,0,0,0,1,1,1,2,1
1,1,1,1,1,1,1,0,0,0,0,0,0,0,0,1,1,1,2,1
1,1,1,1,1,1,1,0,0,0,0,0,0,0,0,1,1,1,2,1
1,1,1,1,1,1,1,0,0,0,0,0,0,0,0,1,1,1,2,1
1,1,1,1,1,1,1,0,0,0,0,0,0,0,0,0,0,0,2,1
1,1,1,1,1,1,1,0,0,0,0,0,0,0,0,0,0,0,2,1
1,1,1,1,1,1,1,0,0,0,5,3,0,0,0,1,1,1,1,1
1,1,1,1,1,1,1,0,0,0,1,1,0,0,0,1,1,1,1,1
