25
25
tileset1.png
map4.map
1,0,0,0,0,0,0,0,0,0,0,0,0,0,0,0,0,0,0,0,0,0,0,0,0
1,4,0,0,0,0,11,0,0,0,0,0,0,0,0,0,0,0,0,0,0,0,0,0,0
1,1,1,1,1,1,1,1,1,0,0,0,0,0,0,0,0,0,0,0,0,0,2,0,0
1,10,0,0,0,0,0,0,1,1,1,1,1,0,0,1,1,1,1,1,1,1,2,0,0
1,1,1,1,1,1,1,1,1,1,1,1,1,0,0,1,1,1,1,1,1,1,2,0,0
1,2,0,1,0,0,0,0,0,0,0,0,0,0,0,1,1,0,0,0,0,0,2,0,0
1,2,12,1,0,0,0,0,0,0,0,0,0,0,0,1,1,0,0,0,0,0,2,0,0
1,2,1,1,0,0,0,6,0,0,6,0,0,0,0,1,1,0,0,0,0,0,2,0,0
1,2,1,0,0,0,1,1,1,1,1,1,1,1,1,1,1,0,0,0,0,0,2,0,0
1,2,1,0,0,0,1,1,1,1,1,1,1,1,1,1,1,0,0,0,0,0,2,0,0
1,2,1,0,0,0,0,0,0,0,0,0,0,0,0,1,1,0,0,0,0,0,2,0,0
1,2,1,0,0,0,0,0,0,0,9,0,0,0,0,1,1,0,0,0,0,0,2,0,0
1,2,1,0,0,0,0,0,0,1,1,1,0,0,0,1,1,0,0,0,0,0,2,0,0
1,2,1,0,0,0,0,0,0,0,0,0,0,0,0,1,1,0,0,0,0,0,2,0,0
1,2,1,0,0,0,0,6,0,0,0,0,0,0,0,1,1,0,0,0,0,0,2,0,0
1,2,1,1,1,1,1,1,1,1,1,0,0,0,0,1,1,0,0,0,0,0,2,0,0
1,2,1,1,1,1,1,1,1,1,0,0,0,0,0,1,11,0,0,0,0,0,2,0,0
1,2,0,0,0,0,0,0,0,0,0,0,0,0,12,1,1,0,0,0,0,0,2,0,0
1,2,0,0,0,0,0,0,0,0,0,0,0,1,1,1,1,0,0,0,0,0,2,0,0
1,2,0,0,0,0,0,0,0,0,0,0,0,1,1,1,1,0,0,3,0,0,2,12,3
1,1,1,1,1,1,1,0,0,0,0,0,0,0,0,1,1,0,0,1,1,1,1,1,1
1,1,1,1,1,1,1,0,0,0,0,0,0,0,0,1,1,0,0,1,1,1,1,1,1
1,1,1,1,1,1,1,0,0,0,0,0,0,0,0,1,1,0,0,1,1,1,1,1,1
1,1,1,1,1,1,1,0,0,0,5,0,0,0,0,1,1,0,0,1,1,1,1,11,1
1,1,1,1,1,1,1,0,0,0,1,0,0,0,0,1,1,0,0,1,1,1,1,1,1
